111111111111111111
1E0001000001100X01
101111010000000001
1011110001000C0001
1P000C010100000011
1C01C1011100000111
1C0000010000000011
1C0000010000000011
111111111111111111