1111111111111111111111111111111111
1011110100100000101001000000010111
1010010010101010001001000000010101
100000000P000000000000001010000001
1010010100100C00101001000000010101
10000C0010101010001001000000010101
1000000100100000101001000000010101
10C001001010101E010010C00000101011
10000001001000001010010000X0010111
1000000000000000000000001010000001
1010010100100C00101001000000010101
10000C0010101010001001000000010101
1000000100100000101001000000010101
1011100010101010001001000000010101
1111111111111111111111111111111111