11111111111111111
1E000100000110001
10111101000000001
1011110000100C001
1P000C01010000011
1C01C101111000111
1C00000100C000011
11111111111111111