11111111111111111111111111111111111111111111111111
10000000000000000000000000100111111100000000000001
100011000000000000000000001000000P0000000000000001
1000110000000001000000000010000000000C000000000001
1C001110000000000000100000100000000000000000000001
10001110000000100000000000010000000000000000000001
11111110000000000000000111110000000000000000000001
10000000000000000100000001110000000000000000000001
10000000000000000100000000000000000000C00000000001
10000000000000000100000000000000000000000000000001
10000000000000000100000000000000000111100000000001
10000000000000000100000000000000111111000000000001
10000000000000000000000000000001111111000000000001
10011110000000000100000000000000000000000000000001
10000000000000000000000000000000000000E00000000001
10000000000000000100000000000000000000000000000001
10000000000001000000000000000000000000000000000001
100000000000010000000000000000000000X0000000000001
10111110000001000000000000000000000000000000000001
10000000000000000000000000000000000000000000000001
10000001100001000000000000000000000000000000000001
1000000C00000000000000000000000000000CC00000000001
10000000000000011000000000000000000000000000000001
1000000C000000000000000011110000000000000000000001
11111111111111111111111111111111111111111111111111