1111111111111111111111111111111111
1011110100100000101001000000010111
1011110010101010001001000000010101
100000000P000000000000001010000001
1011110100100C00101001000000010101
1011110010101010001001000000010101
1011110100100000101001000000010101
1011110010101010E010010C0000010101
1011110100100000101001000000010101
1011110010101010001001000000010101
1111111111111111111111111111111111